|-------|---|---|---|-----------|---------|-|---|-----------
| |-  --  |   --| | ----|---  | |-----| |   | | ----------  
| |---|-------    |---| | |-----  |-  | ----  |-----|---|---
| | | | ------| --| |-  | | | --|-| |---|-  | | --| | | --| 
|   |-  |-  | --|   | --|   --| |   | | | --| | | | | |-    
|---| ------|-  |---|-  | |-  | ----| | |-  |-  |-  | | |---
|-  |-----| | --| | | | | |-----|-    | | --  |-  |---  | | 
| --  |-  | ----  | --| | | --| |-  |-| | --------  |-  |-  
| |---| ----  --|---| | |-  | |   |-|   |---| | ------|-  | 
|   | --------|-  |   |   |-  ----| --|-|-  |-------|   |-  
| | |-----|-  | |---|-  |-  | ------  |   |-  | |-  --|-  | 
| --| |-  |---  | |   |---  |-------|---  |---| | |-  | |-  
|-  | --| | |-|-  |-----| |---|---|   | |-  | --  | --| ----
|-----| | |   | --  |-  | |-    | ----  | ------| --| |-  | 
  |-  | | --| ------| |-  | --|-----|-------|-  |-  --| |---
|-| --  |-  |-  --| | | |---|   | | | |---| | --|---  | |-  
| ------| --|-----| | | |-  |---| --    | | |-  | ----|   | 
|---| |---  | --| --  | | |-  | --|-----|-  | |-----| |---| 
| | | | |---|-| |---|-| | | --| | | |-    |-  | --| | | |   
|-  | |   | |   |-  | |   --  | --  | |-------|-  --| | |---
| |-| ----| |-  | --  --| |---|-  |-  ------|   |-  |     | 
| | --  | |   |-  | |-| |-  | | |-  | --|-  |---| |-------  
| |---| | --| ----| |   | |-| --| |---  | --| --| |-  |---| 
| | |   | | |---| | ----  | |-|   | |-  | |---|   | ----  | 
| | --|-  |-  | | |---| --  | --  |-  |-  | |   | --|---  | 
| |-  | --| |-|-  | | |-  |-------| ------  |---  |   |-|-  
|   ------| | | ----  | --  |---| --|-----| | |---|---  | --
|-  |---|     |---| --|---|-  | |-  | --| --| | | | |-----  
| |---|   |---  ----| | | | | | --|---| |-  |   --|   | |---
|   | ----  --| --|   | --  | --|   |   | ------  |-  | --  
