+---+-+-+-+-----+----++-+-----|
|+ - | -||--+- |+--|| ||----- |
|+-+---  +-||+-- + |-- +--+-+-|
||||---|-|+ |||-+|+-+ ||-|||-||
| + + |-| |-| -|| |||-|||||+  |
+-|---+ +-+ |+ |--||+ + + ||+-|
+ +--||-|||||+--+  ||- + +- |||
|- + |-- |-|||-|+ +||---- + + |
|+-|-- -+-||+ || +| +-||---+ ||
| |----+ | | + --|-++ +---| + |
||+--+ |+-+ + |--- | + |+ -+ ||
|-|+ +- || +- +---+- +-||+ |+ |
+ |-||++ +--|+-+-| |+ |- |-|--|
+--||| |- + |+  |-- |---|-|+ ||
 + ||-|---|+ |-+--+---+ + -|+-|
+|- + + -|||+-| |||+-||-+- |+ |
|---|-+--|||+ +-|-  ||+ |--| ||
+-|+- |-|- ||+ |-+--+ |+--|+-||
||||+-+|+-+|||-|||+  + |-|||| |
+ || || + || - |- |+---+ -||+-|
|+|--|+ |- -|+-+ + ---| + |  ||
||- || + |+|+ ||+ |-+ +-|+--- |
|+-||-|--|| |+|-|+- |-|-|+ +-||
||| ||+-||-- |+| |+ |+-| |-- ||
||-+ + ||+-|- |- + + || |-+- ||
|+ |-|++ ||+ +---|--- +- | ++ |
| ---|||-- |- +-|-+--||+-+- |-|
+ +-|  +-|-+-+ |+ |-|-||||+-- |
|+-| +- --||||||-+-|+ | -| |+-|
| |-- -|-| |- |-| | |--- + |- |
-------------------------------
